NO texture/wood.xpm
SO texture/greystone.xpm
WE texture/redbrick.xpm
EA texture/mossy.xpm

C 41,146,255
F 0,196,0

111111111111111111111111
100000000000000000000001
100000000000000000000001
100000000000000000000001
100000000000000000000001
100000000000100000000001
100000000000100000000001
100000000000100000000001
100000000000100000000001
100000000000100000000001
111111111111111111111111
