      NO texture/wood.xpm
SO texture/greystone.xpm
WE      texture/redbrick.xpm
SO      texture/mossy.xpm
      NO texture/eagle.xpm
        NO texture/eagle.xpm
   EA      texture/mossy.xpm

C 41, 146, 255
F 0, 196, 0

     111111111111111
11111100000000000001
100D0000000011111111
111110P0P011111
1000000000000B1
100000000000001
1000B000N000001
100000000000001
1000100100000011111
1000000100000000001
1111111111111111111
