      NO texture/wood.xpm
SO texture/greystone.xpm
WE      texture/redbrick.xpm
   EA      texture/mossy.xpm

C 41, 146, 255
F 0, 196, 0

     111111111111111
11111100000000000001
10000000000011111111
111110000011111
100000000000001
100000000000001
100000000000001
10000000E000001
1000100100000011111
1000000100000000001
1111111111111111111
