NO texture/wood.xpm
SO texture/greystone.xpm
WE texture/redbrick.xpm
EA texture/mossy.xpm

C 41, 146, 255
F 0, 196, 0

     111111111111111
11111100000000000001
100D00000S0011111111
111110000011111
100000000000001
10000000N000001
100011100000001
10001 100000001
1000111000000011111
10000000010000000G1
1111111111111111111
