      NO texture/wood.xpm
SO texture/greystone.xpm
WE      texture/redbrick.xpm
SO      texture/mossy.xpm
      NO texture/eagle.xpm
        NO texture/eagle.xpm
   EA      texture/mossy.xpm

C 41, 146, 255
F 0, 196, 0

     111111111111111
111111B00G000000G001
100D00000W0011111111
111110P0P011111
1000G00000000B1
1000000G0BW0001
100011100000001
10001 10000G001
1000111000000011111
1000000001000000001
1111111111111111111
